***SIZE
200
17

***LAYOUT
0,0,0,0,0,0,0,0,0,0,0,0,0,0,0,0,0,0,0,0,0,0,0,0,0,0,0,0,0,0,0,0,0,0,0,0,0,0,0,0,0,0,0,0,0,0,0,0,0,0,0,0,0,0,0,0,0,0,0,0,0,0,0,0,0,0,0,0,0,0,0,0,0,0,0,0,0,-,0
0,0,0,0,0,0,0,0,0,0,0,0,0,0,0,0,0,0,0,0,0,0,0,0,0,0,0,0,0,0,0,0,0,0,0,0,0,0,0,0,0,0,0,0,0,0,0,0,0,0,0,0,0,0,0,0,0,0,0,0,0,0,0,0,0,0,0,0,0,0,0,0,0,0,0,0,0,-,0
0,0,0,0,0,0,0,0,0,0,0,0,0,0,0,0,0,0,0,0,0,0,0,0,0,0,0,0,0,0,0,0,0,0,0,0,0,0,0,0,0,0,0,0,0,0,0,0,0,0,0,0,0,0,0,0,0,0,0,0,0,0,0,0,0,0,0,0,0,0,0,0,0,0,0,0,0,-,0
0,0,-,0,0,0,0,-,0,0,0,0,0,0,0,0,0,0,0,0,0,0,0,0,0,0,0,0,0,0,0,0,0,0,0,0,0,0,0,0,0,0,0,0,0,0,0,0,0,0,0,0,0,0,0,0,0,0,0,0,0,0,0,0,0,0,0,0,0,0,0,0,0,0,0,0,0,-,0
0,0,-,0,0,0,0,-,0,0,0,0,0,0,0,0,0,0,0,0,0,0,0,0,0,0,0,0,0,0,0,0,0,0,0,0,0,0,0,0,0,0,0,0,0,0,0,0,0,0,0,0,0,0,0,0,0,0,0,0,0,0,0,0,0,0,0,0,0,0,0,0,0,0,0,0,0,-,0
0,0,-,0,0,0,0,-,0,0,0,0,0,0,0,0,0,0,P,0,0,0,0,0,0,0,0,0,0,0,0,0,0,0,0,0,0,0,0,0,0,0,0,0,0,0,0,0,0,0,0,0,0,0,0,0,0,0,0,0,0,0,0,0,0,0,0,0,0,0,0,0,0,0,0,0,0,-,0
0,0,-,0,0,0,0,-,0,0,0,0,0,0,0,0,0,0,0,0,0,0,0,0,0,0,0,0,0,0,0,0,0,0,0,0,0,0,0,0,0,0,0,0,0,0,0,0,0,0,0,0,0,0,0,0,0,0,0,0,0,0,0,0,0,0,0,0,0,0,/s1,/s2,-,-,-,-
0,0,-,0,0,0,0,-,-,-,-,-,0,0,0,0,0,0,0,0,0,0,0,0,0,0,0,0,0,0,0,0,0,0,0,0,0,0,0,0,0,0,0,0,0,0,0,0,0,0,0,0,0,0,0,0,0,0,0,0,0,0,0,0,0,0,0,0,/s1,/s2,-,-,-,-,-,-
0,0,-,0,0,0,0,0,0,0,0,0,0,0,0,0,0,0,0,0,0,0,0,0,0,0,0,0,0,0,0,0,0,0,0,0,0,0,0,0,0,0,0,0,0,0,0,0,0,0,0,0,0,0,0,0,0,0,0,0,0,0,0,0,0,0,/s1,/s2,-,-,-,-,-,-,-,-
0,0,-,0,0,0,0,0,0,0,0,0,0,0,0,0,0,0,0,0,0,0,0,0,0,0,0,0,0,0,0,0,0,0,0,0,0,0,0,0,0,0,0,0,0,0,0,0,0,0,0,0,0,0,0,0,0,0,0,0,0,0,0,0,/s1,/s2,-,-,-,-,-,-,-,-,-,-,-
0,0,-,0,0,0,0,0,0,0,0,0,0,0,0,0,0,0,0,0,0,0,0,0,0,/,-,-,-,-,-,-,-,-,\s1,\s2,0,0,0,0,0,0,0,0,0,0,0,0,0,0,0,0,0,0,0,0,0,0,0,0,/s1,/s2,-,-,-,-,-,-,-,-,-,-,-,-,-
0,0,-,-,-,-,-,-,-,0,0,0,-,\,0,0,0,0,0,0,0,0,0,0,/,-,-,-,-,-,-,-,-,-,-,-,\s1,\s2,0,0,0,0,0,0,0,0,0,0,0,0,0,0,0,0,0,0,0,0,/s1,/s2,-,-,-,-,-,-,-,-,-,-,-,-,-,-,-
0,0,0,0,0,0,0,0,0,-,0,0,0,-,\,0,0,0,0,0,0,0,0,/,-,-,-,-,-,-,-,-,-,-,-,-,-,-,\s1,\s2,0,0,0,0,0,0,0,0,0,0,0,0,0,0,0,0,/s1,/s2,-,-,-,-,-,-,-,-,-,-,-,-,-,-,-,-,-
0,0,0,0,0,0,0,0,0,0,0,0,0,-,-,\,0,0,0,0,0,0,/,-,-,-,-,-,-,-,-,-,-,-,-,-,-,-,-,-,\s1,\s2,0,0,0,0,0,0,0,0,0,0,0,0,/s1,/s2,-,-,-,-,-,-,-,-,-,-,-,-,-,-,-,-,-,-,-
0,0,0,0,0,0,0,0,0,0,0,0,0,-,-,-,-,0,0,0,0,/,-,-,-,-,-,-,-,-,-,-,-,-,-,-,-,-,-,-,-,-,\s1,\s2,0,0,0,0,0,0,0,0,/s1,/s2,-,-,-,-,-,-,-,-,-,-,-,-,-,-,-,-,-,-,-,-,-
0,0,0,0,0,0,0,0,0,0,0,0,0,-,-,-,-,-,-,-,-,-,-,-,-,-,-,-,-,-,-,-,-,-,-,-,-,-,-,-,-,-,-,-,\s1,\s2,0,0,N,0,/s1,/s2,-,-,-,-,-,-,-,-,-,-,-,-,-,-,-,-,-,-,-,-,-,-,-
-,-,-,-,-,-,-,-,-,-,-,-,-,-,-,-,-,-,-,-,-,-,-,-,-,-,-,-,-,-,-,-,-,-,-,-,-,-,-,-,-,-,-,-,-,-,-,-,-,-,-,-,-,-,-,-,-,-,-,-,-,-,-,-,-,-,-,-,-,-,-,-,-,-,-,-,-,-,-
